-R------
RRRRRR--
-R-R-R--
-R-R-R--
-RRR-RRR
-R------
